----------------------------------------------------------------
-_________--___--______________-____________-__________________-
-_________--___________________G____________-_______________H__-
-_________--___________________-____________-___-_____B________-
-_____G___--___--_____-________-____-_______-___-______________-
-_________--___--_____----------____-_______-___-__G___H_____G_-
-_________-------_____-____G___-____-_______-___----------------
-_________-------_____-________-____-_______-___-______________-
-_________--__________-________-____-_______-___-______________-
-_________--___________________-____-_______-___-______________-
-_________--___________________------_______-___-______________-
-_________----------___________-____-_______-__---------_______-
-_________----------___________-____----__---__-_________-------
-_________--___________________-____-__________-_______________-
-_________--___________________-____-__________-________G______-
-_________--______________G____-____-__________________________-
-_________-------______________-____-__________________-_______-
-___E_____-------______________-_______________-_______-_______-
-_________--_W_--______________-_______________-_______-_______-
-_________--___--_____----------_______________-_______-_______-
-_________--___--______________-_________E_____-_______-_______-
-_________--___--______________-_______________-_______-_______-
-_________--___--______________-_______________-----------------
-_________--___--___E__________-__________G____-----------------
-_________--___--______________-_______________-_______________-
-_____G________________________-______________________P________-
-______________________________-_______________-_______________-
----__-------__-----------------------__---------------__-------
-__________-___________________-____-__________-_______________-
-__________-___________________-____-__________________-_______-
-___E______-ooo-_______________-_______________-_______-_______-
----------------------------------------------------------------