----------------------------------------------------------------
-__________-___-_______________-____________-__________________-
-__________-___________________G____________-___-___________H__-
-__________-___-_______________-____________-___-_____B________-
-_____G____-___-______-________-____-_______-___-______________-
-__________-___-______----------____-_______-___-__G___H_____G_-
-__________-_H_-______-____G___-____-_______-___----------------
-__________-----______-________-____-_______-___-______________-
-__________-__________-________-____-_______-___-______________-
-__________-___________________-____-_______-___-______________-
-__________-___________________------_______-___-______________-
-__________-___________________-____-_______-__---------_______-
-__________---------___________-____-----_---__-_________-------
-__________-___________________-____-__________-_______________-
-__________-___________________-____-__________-________G______-
-__________-______________G____-____-__________-_______________-
-__________-___________________-____-__________________-_______-
-___E______-----_______________-_______________-_______-_______-
-__________-_W_-_______________-_______________-_______-_______-
-__________-___-______----------_______________-_______-_______-
-__________-___-_______________-_________E_____-_______-_______-
-__________-___-_______________-_______________-_______-_______-
-__________-___-_______________-_______________-----------------
-__________-___-____E__________-__________G____-----------------
-__________-___-_______________-_______________-_______________-
-_____G________________________-______________________P________-
-______________________________-_______________-_______________-
----_--------__-----------------------__---------------__-------
-__________-___________________-____-__________-_______________-
-__________-___________________-____-__________________-_______-
-___E______-ooo-_______________-_______________-_______-_______-
----------------------------------------------------------------